***********************************************************
*                                                         *
* **********     **     ***** *****     **     ********** *
* **********     **     ***** *****     **     ********** *
* **********     **     ***** *****     **     ********** *
*                                                         *
*                                                         *
* *************************** ***** ********************* *
*                                                         *
* ********** ***** ********** ***** **** ***** ********** *
*            *****                       *****            *
* ********** ***** ********** ***** **** ***** ********** *
*                                                         *
* *************************** ***** ********************* *
*                                                         *
*                                                         *
* **********     **     ***** *****     **     ********** *
* **********     **     ***** *****     **     ********** *
* **********     **     ***** *****     **     ********** * 
*                                                         *
*                                                         *
*                                                         *
*                                                         *
***********************************************************
